11111111111111111111111111111111111111111
1G000000000000000011111111111111111111111
11111111111111111011111111111111111111111
11111111111111111011111111111111111111111
11111111111111111011111111111111111111111
1G000000000011111011111111111111111111111
11111111111011111011111111111111111111111
11111111111011111011111111111111111111111
11111111111011111011111111111111111111111
1G000011111011111011111111111111111111111
11111011111011111011111111111111111111111
11111011111011111011111111111111111111111
11111011111011111011111111111111111111111
1G0G0PCCCCCCCCCCCCCCCCCCCCCCCCCCCCCCCCCE1
11011111011111011111111111111111111111111
1G011111011111011111111111111111111111111
11111111011111011111111111111111111111111
11111111011111011111111111111111111111111
11111111011111011111111111111111111111111
1G000000011111011111111111111111111111111
11111111111111011111111111111111111111111
11111111111111011111111111111111111111111
11111111111111011111111111111111111111111
1G000000000000011111111111111111111111111
11111111111111111111111111111111111111111
11111111111111111111111111111111111111111
11111111111111111111111111111111111111111